变量	bian liang	1
常量	chang liang	1
成员	cheng yuan	1
成员方法	cheng yuan fang fa	1
成员函数	cheng yuan han shu	1
成员属性	cheng yuan shu xing	1
初始化	chu shi hua	1
代理模式	dai li mo shi	1
第一类对象	di yi lei dui xiang	1
方法	fang fa	1
访问器	fang wen qi	1
构造函数	gou zao han shu	1
哈希	ha xi	1
函数式	han shu shi	1
局部变量	ju bu bian liang	1
类变量	lei bian liang	1
鲁棒性	lu bang xing	1
面向对象	mian xiang dui xiang	1
面向过程	mian xiang guo cheng	1
全局变量	quan ju bian liang	1
实例	shi li	1
实例变量	shi li bian liang	1
属性	shu xing	1
属性代理	shu xing dai li	1
伪变量	wei bian liang	1
委托代理	wei tuo dai li	1
析构函数	xi gou han shu	1
协程	xie cheng	1
